###############
#             #
#  ##  #####  #
# #### ##  #   
#    # #  ##  #
###### # ##   #
# # ####    ###
# ###  ###### #
# # #         #
#   #### #### #
###      #    #
# # # ## # ####
# # #  # # #  #
#   #    #    #
###############